"filename", "language", "Rust", "comment", "blank", "total"
"d:\programs\rust\rust-blockchain-exercise\src\account\mod.rs", "Rust", 1, 0, 0, 1
"d:\programs\rust\rust-blockchain-exercise\src\account\state.rs", "Rust", 111, 2, 18, 131
"d:\programs\rust\rust-blockchain-exercise\src\config\mod.rs", "Rust", 20, 0, 2, 22
"d:\programs\rust\rust-blockchain-exercise\src\core\block.rs", "Rust", 111, 12, 20, 143
"d:\programs\rust\rust-blockchain-exercise\src\core\blockchain.rs", "Rust", 120, 9, 29, 158
"d:\programs\rust\rust-blockchain-exercise\src\core\mod.rs", "Rust", 3, 0, 0, 3
"d:\programs\rust\rust-blockchain-exercise\src\core\transaction.rs", "Rust", 84, 0, 16, 100
"d:\programs\rust\rust-blockchain-exercise\src\crypto\hash.rs", "Rust", 6, 0, 2, 8
"d:\programs\rust\rust-blockchain-exercise\src\crypto\merkle.rs", "Rust", 38, 3, 10, 51
"d:\programs\rust\rust-blockchain-exercise\src\crypto\mod.rs", "Rust", 2, 0, 0, 2
"d:\programs\rust\rust-blockchain-exercise\src\error\mod.rs", "Rust", 50, 4, 7, 61
"d:\programs\rust\rust-blockchain-exercise\src\main.rs", "Rust", 36, 6, 13, 55
"d:\programs\rust\rust-blockchain-exercise\src\mempool\mod.rs", "Rust", 1, 0, 0, 1
"d:\programs\rust\rust-blockchain-exercise\src\mempool\pool.rs", "Rust", 63, 1, 10, 74
"d:\programs\rust\rust-blockchain-exercise\src\network\mod.rs", "Rust", 50, 1, 9, 60
"d:\programs\rust\rust-blockchain-exercise\src\storage\chain_store.rs", "Rust", 17, 0, 4, 21
"d:\programs\rust\rust-blockchain-exercise\src\storage\mod.rs", "Rust", 1, 0, 0, 1
"d:\programs\rust\rust-blockchain-exercise\src\utils\mod.rs", "Rust", 1, 0, 0, 1
"d:\programs\rust\rust-blockchain-exercise\src\utils\serialization.rs", "Rust", 10, 0, 2, 12
"Total", "-", 725, 38, 142, 905