"filename", "language", "Rust", "comment", "blank", "total"
"d:\programs\rust\rust-blockchain-exercise\src\account\state.rs", "Rust", 101, 1, 18, 120
"d:\programs\rust\rust-blockchain-exercise\src\config\mod.rs", "Rust", 2, 0, 1, 3
"d:\programs\rust\rust-blockchain-exercise\src\core\account.rs", "Rust", -59, 0, -10, -69
"d:\programs\rust\rust-blockchain-exercise\src\core\block.rs", "Rust", 3, 0, 1, 4
"d:\programs\rust\rust-blockchain-exercise\src\core\blockchain.rs", "Rust", 80, 5, 18, 103
"d:\programs\rust\rust-blockchain-exercise\src\core\mod.rs", "Rust", -64, -5, -15, -84
"d:\programs\rust\rust-blockchain-exercise\src\core\validation.rs", "Rust", 0, 1, 0, 1
"d:\programs\rust\rust-blockchain-exercise\src\error\mod.rs", "Rust", 6, 0, 0, 6
"d:\programs\rust\rust-blockchain-exercise\src\storage\chain_store.rs", "Rust", 17, -1, 4, 20
"d:\programs\rust\rust-blockchain-exercise\src\utils\time.rs", "Rust", 0, 1, 0, 1
"Total", "-", 86, 2, 17, 105